Account|Konto||@Krone
AccountingRules|Buchhaltungsvorschriften||@Krone
AcquisitionCostDuringRequest|Anschaffungswert bei Anfrage||@Krone
Actions|Aktionen||@Krone
ActivationRequested|Aktivierung angefragt||@Krone
Active|Aktiv||@Krone
Add|Hinzufügen||@Krone
Adjustment|manuelle Korrektur||@Krone
AdmissionCountry|Zulassungsland||@Krone
AdmissionCountryHelp|Als Zulassungsstelle gilt hier das Land, in dem ein Fahrzeug registriert ist.||@Krone
AdvancePayment|vorschüssige Zahlung||@Krone
Approval|Genehmigung||@Krone
AssetGroups|Anlagengruppen||@Krone
AssetGroupsTable|Anlagengruppentabelle||@Krone
AssetGroupsTableStaging|Anlagengruppen-Stagingtabelle||@Krone
Assets|Anlagen||@Krone
Assume|Übernehmen||@Krone
Availability|Verfügbarkeit||@Krone
AvailAmount|Verfügbarer Betrag||@Krone
AxleNumber|Achsenummer||@Krone
AxleNumberHelp|Die Achsenummer wird von vorne am Geräte gezählt.||@Krone
BadGuy|Bad Guy||@Krone
BankGuaranteeCalc|Garantien und Sicherheiten kalkulieren||@Krone
BankGuaranteeCalcMaintain|Garantien und Sicherheiten kalkulieren verwalten||@Krone
BankGuaranteeErr1|Der Mietauftrag kann nicht bestätigt werden, da keine aktive Bankgarantie besteht.||@Krone
BankGuaranteeErr2|Der Mietauftrag %1 kann nicht bestätigt werden, da der verfügbare Betrag nur %2 %3 beträgt. Bank Garantie: %4||@Krone
BankGuaranteeErr3|Die ausgewählte Bankgarantie %1 läuft in %2 Tagen aus.||@Krone
BankGuaranteeErr4|Die ausgewählte Bankgarantie ist nicht gültig.||@Krone
BankGuaranteeErr5|Die Granatie/Sicherheit %1 reicht nicht aus. Der verfügbare Betrag ist %2 %3, die Gesamtsumme beträgt aber %4 %5.||@Krone
BankGuaranteeErr6|Die Mietauftragswährung und die Währung der Bankgarantie stimmen nicht überein.||@Krone
BankGuaranteeErr7|Verfügbarer Betrag sollte positiv sein, aber ist momentan %1 %2.||@Krone
BankGuaranteeProcess|Bankgarantie Prozess||@Krone
BankGuaranteeProcessMaintain|Bankgarantie Prozess verwalten||@Krone
BankGuaranteeStatus|Bankgarantie Status||@Krone
BankGuaranteeValidation|Bankgarantie Validation||@Krone
BankGuaranteeValidationMaintain|Bankgarantie Validation verwalten||@Krone
BankLetterOfGuaranteeMaintain|Bankgarantieanträge verwalten||@Krone
BankLetterOfGuaranteeView|Bankgarantieanträge anzeigen||@Krone
BankName|Bankname||@Krone
BaseRate|Basis Tarif||@Krone
Begin|Beginn||@Krone
BillingFactor|Verrechnungsfaktor||@Krone
BlockInactiveCustomer|Sperren inaktiver Kunden||@Krone
BlockInactiveCustomerMaintain|Sperren inaktiver Kunden verwalten||@Krone
CalcAnnuity|Annuität berechnen||@Krone
CalcInterest|Zinsen berechnen||@Krone
Calculated|Berechnet||@Krone
CalculationMaskTable|Kalkulationsmaskentabelle||@Krone
CalculationValuesTable|Berechnungswerttabelle||@Krone
CancallationBy|Storniert von||@Krone
CancallationDate|Stornierungsdatum||@Krone
Cancellation|Stornierung||@Krone
Cancelled|Storniert||@Krone
CancelledByUser|Abbruch durch Benutzer||@Krone
CannotBeBefore|Das %1 kann nicht vor dem %2 liegen||@Krone
CantConfirmeRentOrder|Der Mietauftrag kann nicht bestätigt werden, bitte Bankgarantie erstellen.||@Krone
CDSDocumentHandling|CDS Document Handling||@Krone
CDSDocumentHandlingBatch|Dokumentenanhänge aus Dataverse||@Krone
CDSGUID|CDS GUID||@Krone
CDSMissingSetup|Tabelle %2 muss mit dem Feld %1 für die 'Dokumentenanhänge aus Dataverse' integriert werden.||@Krone
ChargingOnOrders|Weiterbelastungsaufträge||@Krone
CheckFailedFieldValueMissing|Kein Wert für '%1 in '%2' angegeben||@Krone
CheckIn|Einchecken||@Krone
CheckOut|Auslieferung||@Krone
Closed|Abgeschlossen||@Krone
CompHierMaintain|Unternehmenshierarchie verwalten||@Krone
CompHierRead|Unternehmenshierarchie lesen||@Krone
Compliance|Compliance||@Krone
ComplianceCheck|Complianceprüfung||@Krone
ComplianceCheckRefreshBatch|Periodische Compliance Prüfung||@Krone
ComplianceCheckRefreshType|Compliance-Aktualisierung Lauf||@Krone
ComplianceCheckResult|Ergebnis Complianceprüfung||@Krone
ComplianceCheckTimeSpan|Zeitraum periodische Complianceprüfung||@Krone
ComplianceCheckUpdateParentBatch|Vererben der Ergebnisse der Compliance Prüfungen||@Krone
ComplianceCustBlockDefaults|Parameter für Debitorensperre||@Krone
ComplianceDateTime|Compliancedatum & -uhrzeit||@Krone
ComplianceDefaultCredManAccountStatusTable|Kontostatus||@Krone
ComplianceDefaultCredManReasonTable|Grund für Kontostatus||@Krone
ComplianceResult|Compliance Ergebnis||@Krone
ComplianceServer|Compliance Server||@Krone
ComplianceStatusInherited|Status vererbt||@Krone
ComplianceUnblock|Parameter für Debitorenentsperrung||@Krone
ComplianceUnblockBatch|Entsperrung durch Compliance Check||@Krone
ConsumedTime|Zeit verbraucht||@Krone
ConsumedTimeHelp|Zeit in Minuten die geleistet wurde||@Krone
ContractAdd|Bestehenden Vertrag hinzufügen||@Krone
ContractConditions|Vertragskonditionen||@Krone
ContractInformation|Vertragsinformationen||@Krone
ContractLine|Vertragsposition||@Krone
ContractLineAlreadyRemoved|Die Vertragsposition '%1' wurde bereits abgelöst.||@Krone
ContractLineDetails|Vertragspositionsdetails||@Krone
ContractLineMissingAssetId|Vertragsposition '%1' fehlt die Anlagennummer||@Krone
ContractPartner|Vertragspartner||@Krone
ContractPeriod|Vertragslaufzeit||@Krone
ContractRemove|Vertrag entfernen||@Krone
Contracts|Verträge||@Krone
ContractType|Vertragstyp||@Krone
ContractTypeHelp|Vertragstyp||@Krone
ContractTypeLimit|Anzahl max. Monate Kurzzeitmiete||@Krone
ContractTypeLimitHelp|Als Kurzeitmiete betrachtet, wenn die Mietdauer kleiner gleich der Anzahl Monate ist||@Krone
CorporateCurrency|Konzernwährung||@Krone
CountryFormat|Land-Format||@Krone
Created|Erstellt||@Krone
CreateTireDataBatch|Reifendaten initialisieren||@Krone
CreateTireDataBatchMaintain|Reifendaten initialisieren verwalten||@Krone
CreditLimitCalculation|Kreditlimit Kalkulation||@Krone
CreditLimitHistory|Historie Kreditwürdigkeit||@Krone
CreditLimitNew|Kreditwürdigkeit||@Krone
CreditLimitOld|Alte Kreditwürdigkeit||@Krone
CredProc|Gutschriftverfahren||@Krone
CredProcHelp|Nimmt Geschäftskontakt an Gutschriftsverfahren teil?||@Krone
Currency|Währung||@Krone
CurrentOperator|Aktuelle Betreiber||@Krone
CustBankGuarantee|Garantien und Sicherheiten||@Krone
CustBankGuaranteeEntityMaintain|Garantien und Sicherheiten Entität verwalten||@Krone
CustBankGuaranteeEntityView|Garantien und Sicherheiten Entität ansehen||@Krone
CustBankGuaranteeMaintain|Garantien und Sicherheiten verwalten||@Krone
CustBankGuaranteeView|Garantien und Sicherheiten ansehen||@Krone
CustCompStructEdge|Kundenstruktur - Zuordnung||@Krone
CustCompStructEdgeTable|Kundenstruktur - Zuordnungstabelle||@Krone
CustCompStructEdgeTableStaging|Kundenstruktur - Zuordnungs - Stagingtabelle||@Krone
CustCompStructVertex|Kundenstruktur - Stammdaten||@Krone
CustCompStructVertexTable|Kundenstruktur - Stammdatentabelle||@Krone
CustCompStructVertexTableStaging|Kundenstruktur - Stammdaten - Stagingtabelle||@Krone
CustInvAcc|Debitoren Rechnungskonto||@Krone
CustInvAccMaintain|Debitoren Rechnungskonto verwalten||@Krone
CustInvAccView|Debitoren Rechnungskonto ansehen||@Krone
CustInvoiceJournalSendBatch|Versenden von Mietrechnungen||@Krone
CustomerAccounts|Debitorenkonten||@Krone
CustomerBlocked|Debitor %1 wurde gesperrt.||@Krone
CustomerStructures|Kundenstrukturen||@Krone
CustomerStructureType|Kundenstruktur - Typ||@Krone
CustParameters|Debitoren Parameter||@Krone
CustRentStop|Die aktuelle Risikobewertung des Kunden %1 erlaubt keine  Bestätigung des Angebots und die Erstellung eines Auftrages||@Krone
CustStructTypeMaintain|Kundestruktur Typen verwalten||@Krone
CustStructTypeRead|Kundestruktur Typen lesen||@Krone
CustStructTypeTable|Kundenstruktur Typ Tabelle||@Krone
CustStructTypeTableStaging|Kundenstruktur Typ Stagingtabelle||@Krone
D365ItemId|D365FO ItemId||@Krone
D365SCMSystem|D365 System||@Krone
D365SCMUser|D365 Anwender||@Krone
DamageId|Schadens-ID||@Krone
Damages|Schäden||@Krone
DamageTbl|Schadenstabelle||@Krone
DamageTblLog|Log Schäden Änderungen||@Krone
DamageTblLogTable|Log Schäden Änderungen Tabelle||@Krone
DamageTblLogView|Log Schäden Änderungen lesen||@Krone
DamageTblMaintain|Schadenstabelle verwalten||@Krone
DamageTblView|Geräte Schäden lesen||@Krone
DateAlreadyInFreePeriod|Das Datum: %1 liegt bereits in einer tilgungsfreien Periode!||@Krone
DateEndBeforeStart|Das Enddatum liegt vor dem Startdatum||@Krone
DateInPostedPeriod|Das Datum liegt in einer bereits gebuchten Periode.||@Krone
DateNotWithinContractPeriods|Das Datum '%1' liegt nicht innerhalb der Tilgungsperioden des Vertrages.||@Krone
DatesAlreadyInFreePeriod|Der Zeitraum von %1 bis %2 liegt bereits in tilgungsfreien Perioden.||@Krone
DatineoDlvOrder|Auslieferungsauftrag an Datineo||@Krone
DatineoPropertyValue|Datineo Wert||@Krone
DatineoPropertyValueHelp|Wert der Eigenschaftsgruppe (Merkmal) falls nach Datineo via Schnittstelle übermittelt wird.||@Krone
DecisionTableDevicePropertySAP|Entscheidungsmatrix SAP Fahrzeugdaten||@Krone
DecisionTableDevicePropertySAPEntityMaintain|Entscheidungsmatrix SAP Fahrzeugdaten Entität verwalten||@Krone
DecisionTableDevicePropertySAPEntityView|Entscheidungsmatrix SAP Fahrzeugdaten Entität einsehen||@Krone
DecisionTableDevicePropertySAPView|Entscheidungsmatrix SAP Fahrzeugdaten einsehen||@Krone
DefaultFinancialDimensions|Standardfinanzdimensionen||@Krone
DeliveryProtocol|Auslieferungsprotkoll||@Krone
DeliveryTermsDescription|Lieferbedingungen-Text||@Krone
DeviceDimKey|Gerät-Dimensionsschlüssel||@Krone
DeviceIDnotFoundInCompany|Die Gerätekennung %1 konnte nicht in dem Mandanten %2 gefunden werden.||@Krone
DeviceMaintenanceType|Servicetyp||@Krone
DeviceNum|Gerätenummer||@Krone
DeviceNumberNotFound|Keine freie Krone Fleet Gerätenummer gefunden||@Krone
DeviceNumbers|Krone Fleet Gerätenummern||@Krone
DeviceNumbersActive|Krone Fleet Gerätenummern verwenden||@Krone
DeviceNumbersDeveloperDocumentation|Die Tabelle RD_DeviceNumbersTable enthält die Liste aller noch verfügbaren und bereits verwendeten Gerätenummern||@Krone
DeviceNumbersEntityMaintain|Krone Fleet Gerätenummer-Entität verwalten||@Krone
DeviceNumbersEntityView|Krone Fleet Gerätenummer-Entität anzeigen||@Krone
DeviceNumbersMaintain|Krone Fleet Gerätenummern verwalten||@Krone
DeviceNumbersParameters|Krone Fleet Geräternummern Parameter||@Krone
DeviceNumbersParametersDeveloperDocumentation|Tabelle wird vor GoLive wieder gelöscht||@Krone
DeviceNumbersView|Krone Fleet Gerätenummern anzeigen||@Krone
DeviceNumHelp|Eindeutige Krone Fleet Gerätenummer||@Krone
DevicePropertyMaintain|Geräteeigenschaften verwalten||@Krone
DevicePropertyType|Fahrzeug Datentypen für Import aus externen Systemen.||@Krone
DevicePropertyTypeBaseData|Stammdaten||@Krone
DevicePropertyTypeNormal|Normal||@Krone
DevicePropertyTypeSpecialData|Spezialdaten||@Krone
DevicePropertyView|Geräteeigenschaften ansehen||@Krone
DevicePropMaintain|Geräteeigenschaften Verwaltung||@Krone
DevMajorStatusDeRegistered|Verschrottet/Verkauft||@Krone
DimensionDeviceNum|Finanzdimension Krone Fleet Geräte-ID||@Krone
DimensionNameNotFound|Dimension mit Name '%1' nicht gefunden||@Krone
DirectEdge|Direct Edge||@Krone
Dlv|Auslieferung||@Krone
DlvHelp|Aktivitäten in Verbindung mit der Auslieferung eines Mietgeräts an den Kunden.||@Krone
DmgApprove|Schaden Reparatur Genehmigt||@Krone
DmgApproveHelp|Wurde der Reparatur des Schadens genehmigt?||@Krone
DmgCompleted|Schaden abgeschlosssen||@Krone
DmgCompletedHelp|Wurde der Schadensabwicklung abgeschlossen?||@Krone
DmgErr|Schaden konnte nicht angelegt werden, da kein zugehöriger Mietauftrag gefunden werden konnte.||@Krone
DmgMaintain|Schäden verwalten||@Krone
DmgRated|Schaden bewertet||@Krone
DmgRatedHelp|Liegt eine Schadensbewertung vor?||@Krone
DmgReason|Schadensursache||@Krone
DmgRepairClosed|Schaden Reparatur abgeschlossen||@Krone
DmgRepairClosedHelp|Ist der Schaden repariert, Abgenommen und finanziell ausgeglichen worden?||@Krone
DmgRepaired|Schaden repariert||@Krone
DmgRepairedHelp|Wurde der Schaden durch eine Werkstatt behoben?||@Krone
DmgView|Schäden ansehen||@Krone
DocumentHandlingBatch|Importierte URL Anhänge verarbeiten||@Krone
DocumentURLAddSucces|Dokumenten URL wurde erfolgreich hinzugefügt||@Krone
DummyNumSeq|Nummernkreis||@Krone
DummyProduct|Dummy-Produkt||@Krone
DVField|Dataverse Feld||@Krone
DVTable|Dataverse Tabelle||@Krone
DV_CustTable|Dataverse Debitoren||@Krone
DV_Dashbord|Dashboard||@Krone
DWError|Datensatz konnte nicht an Dataverse übermittelt werden.||@Krone
DWMissingField|Feld %1 ist nicht auf Tabelle %2 vorhanden.||@Krone
DWUpdate|Dual Write Update||@Krone
DWUpdateBatch|Dual Write Update Batch||@Krone
DWUpdateBatchMaintain|Dual Write Update Batch verwalten||@Krone
End|Ende||@Krone
EntryEdge|Entry Edge||@Krone
EnumLookupTmp|Enumsuche-Temp-Tabelle||@Krone
EnumValue|Enum Wert||@Krone
ErrorGreater|Fehler: %1 > %2||@Krone
ErrorNotAvailable|Das Mietgerät darf nicht ausgeliefert werden, da die Verfügbarkeit auf '%1' steht.||@Krone
ErrorTxt|Fehler||@Krone
ErrorTxtH|Fehlermeldung||@Krone
ExhaustAmount|Ausgeschöpfter Betrag||@Krone
ExitEdge|Exit Edge||@Krone
ExpectedScrapValuePercent|Voraussichtlicher Schrottwert (Prozent)||@Krone
ExpiredGuarantees|Garantien und Sicherheiten - Abgelaufen||@Krone
ExportDatineo|Export Datineo||@Krone
ExportDatineoHelp|Wenn Wert Ja, wird die Eigenschaftsgruppe nach Datineo in den Schnittstellen für Fahrzeugdaten exportiert.||@Krone
ExtDescription|Beschreibung||@Krone
ExtDescriptionDE|Beschreibung DE||@Krone
ExtDescriptionDK|Beschreibung DK||@Krone
ExtDescriptionENG|Beschreibung ENG||@Krone
ExtDescriptionESP|Beschreibung ESP||@Krone
ExtDescriptionFR|Beschreibung FR||@Krone
ExtDescriptionH|ECR Beschreibung||@Krone
ExtDescriptionNED|Beschreibung NED||@Krone
ExternalContractNumber|Externe Vertragsnummer||@Krone
ExternalVendAccount|Externe Kreditorennummer||@Krone
ExternalVendAccounts|Externe Kreditoren Nummern||@Krone
ExtHourlyRate|Stundensatz Extern||@Krone
ExtImpError|Ext.Artikel %1: allg. Fehler bei Anlage||@Krone
ExtImpError1|Ext. Artikel %1: D365 Artikel fehlt||@Krone
ExtImpError2|Ext. Artikel %1: Mapping für Artikelgruppe fehlt||@Krone
ExtImpError3|Zeile %1: %2||@Krone
ExtImpError4|Artikel wurde nicht erstellt||@Krone
ExtImpError5|Produkt wurde nicht erstellt||@Krone
ExtImpInfo|Erstellt %1||@Krone
ExtImpInfo1|Es wurden %1 Artikel importiert||@Krone
ExtImpInvent|Lagersteuerungsgruppe ist nicht vorhanden||@Krone
ExtImpItem|ECR Importartikel||@Krone
ExtImpItemBtn|Erstellen/Ändern||@Krone
ExtImpItemH|Übersicht ECR Importartikel ||@Krone
ExtImpItemMaintain|ECR Artikelimport verwalten||@Krone
ExtImpItemView|ECR Artikelimport lesen||@Krone
ExtImpLocationId|Lagerort fehlt||@Krone
ExtImpNumbersequence|Nummernkreis ist nicht vorhanden||@Krone
ExtImportItemEntityLabel|ECR Importartikel||@Krone
ExtImpPraefix|Import externe Artikel||@Krone
ExtImpProduct|Dummy-Produkt ist nicht vorhanden||@Krone
ExtImpProgress|Externe Artikel %1||@Krone
ExtImpProgressText|Externe Artikel %1||@Krone
ExtImpProgressTitle|Artikel||@Krone
ExtImpPurchTax|Einkauf-Steuergruppe ist nicht vorhanden||@Krone
ExtImpSalesTax|Verkauf-Steuergruppe ist nicht vorhanden||@Krone
ExtImpSiteId|Standort fehlt||@Krone
ExtImpState|Status||@Krone
ExtImpStateError|Fehler||@Krone
ExtImpStateImp|Importiert||@Krone
ExtImpStateNew|Neu||@Krone
ExtImpStateUpd|Änderung||@Krone
ExtImpStateUpdTxt|Text-Änderung||@Krone
ExtImpUnit|Einheit fehlt||@Krone
ExtImpUpdate|Geändert %1||@Krone
ExtItem|Ext-ItemId||@Krone
ExtItemGrid|Übersicht||@Krone
ExtItemGroup|Artikelgruppe||@Krone
ExtItemGroupForm|Externe Artikelgruppen||@Krone
ExtItemGroupFormHelp|ECR externe Artikelgruppen||@Krone
ExtItemGroupH|ECR Artikelgruppe||@Krone
ExtItemImport|ECR Artikelimport||@Krone
ExtItemImpParam|Artikelimport||@Krone
ExtName|Name||@Krone
ExtNameDE|Name DE||@Krone
ExtNameDK|Name DK||@Krone
ExtNameENG|Name ENG||@Krone
ExtNameESP|Name ESP||@Krone
ExtNameFR|Name FR||@Krone
ExtNameH|ECR Name||@Krone
ExtNameNED|Name NED||@Krone
ExtOverview|Übersicht||@Krone
ExtPosition|Position||@Krone
ExtPositionHelp|Externe Position||@Krone
ExtPurchId|Externe Bestellnummer||@Krone
ExtPurchIdHelp|Bestellnummer aus dem Ordersystem||@Krone
Extradition|Auslieferung||@Krone
ExtraditionHelp|Auslieferung mittels Inspektion||@Krone
ExtraditionMaintain|Auslieferung verwalten||@Krone
ExtraIdentifier|Zusätzliche Kennung Nordea||@Krone
FaultId|Mängel-ID||@Krone
FinalRate|Schlussrate||@Krone
FinalRateAccount|Konto Schlussrate||@Krone
FinalRateInPercent|Schlussrate in %||@Krone
FinalRateInvoiceExpectationAccount|Konto Rechnungserwartung Schlussrate||@Krone
FinalRateOffsetAccount|Gegenkonto Schlussrate||@Krone
FinalRateType|Schlussratentyp||@Krone
FinancalPartner|Finanzierungspartner||@Krone
FinancialConditions|Tilgungsplankonditionen||@Krone
FinancialDimensions|Finanzdimensionen||@Krone
FinancialPostings|Finanzierungsbuchungen||@Krone
Financing|Finanzierung||@Krone
FinancingAmount|Finanzierungsbetrag||@Krone
FinancingAmountCorporate|Finanzierungsbetrag in Konzernwährung||@Krone
FinancingAmountMST|Finanzierungsbetrag in Unternehmenswährung||@Krone
FinancingAmountOrig|Finanzierungsbetrag bei Anfrage||@Krone
FinancingAnnuityAmount|Annuität||@Krone
FinancingApproved|Finanzierung genehmigt||@Krone
FinancingConditions|Finanzierungskonditionen||@Krone
FinancingContract|Finanzierungsvertrag||@Krone
FinancingContractAlreadyApproved|Der Finanzierungsvertrag '%1' wurde bereits genehmigt||@Krone
FinancingContractApprovalPosition|Finanzierungsvertragsgenehmigungsposition||@Krone
FinancingContractCreate|Finanzierungsvertrag erstellen||@Krone
FinancingContractCust|Debitorische Finanzierungsverträge||@Krone
FinancingContractIdExternal|Vertragsnummer extern||@Krone
FinancingContractInvoiceMethod|Finanzierungsvertrag-Rechnungsmethode||@Krone
FinancingContractLine|Finanzierungsvertragsposition||@Krone
FinancingContractPlaceholder|Finanzierungsvertrag '%1'||@Krone
FinancingContractRepaymentDurationDiff|Der berechnete Tilgungsplan weicht von der vorgegebenen Vertragslaufzeit ab. Prüfen Sie die Vertragskonditionen.||@Krone
FinancingContracts|Finanzierungsverträge||@Krone
FinancingContractTerminate|Vertrag auflösen||@Krone
FinancingContractWrongStatus|Der Finanzierungsvertrag hat einen inkorrekten Status||@Krone
FinancingData|Finanzierungsdaten||@Krone
FinancingInquire|Finanzierung Anzeigen  ||@Krone
FinancingJournalTransDesc|%1 zu Finanzierung %2, Periode %3, Position %4||@Krone
FinancingLineFromAssetBook|Aus Anlagen hinzufügen||@Krone
FinancingLineFromPurchLine|Aus Bestellpositionen hinzufügen||@Krone
FinancingMaintain|Finanzierung Verwalten||@Krone
FinancingMasterContract|Finanzierungsrahmenvertrag||@Krone
FinancingMasterContractCreate|Finanzierungsrahmenvertrag erstellen||@Krone
FinancingMasterContracts|Finanzierungsrahmenverträge||@Krone
FinancingMasterContractsEntity|Finanzierungsrahmenverträge Entität||@Krone
FinancingMasterContractsEntityMaintain|Verwalten Finanzierungsrahmenverträge Entität||@Krone
FinancingMasterContractsEntityView|Anzeigen Finanzierungsrahmenverträge Entität||@Krone
FinancingMasterContractsMaintain|Verwalten Finanzierungsrahmenveträge||@Krone
FinancingMasterContractsView|Anzeigen Finanzierungsrahmenverträge ||@Krone
FinancingParameters|Finanzierungsparameter||@Krone
FinancingPartner|Finanzierungspartner||@Krone
FinancingRemovalLinkTable|Finanzierungsentfernung-Verknüpfungstabelle||@Krone
FinancingRepayDetails|Tilgungsplandetails||@Krone
FinancingRepayment|Tilgungplan||@Krone
FinancingRepaymentFinalRateDiff|Der berechnete Tilgungsplan weicht von der vorgegebenen Schlussrate ab. Prüfen Sie die Vertragskonditionen.||@Krone
FinancingRepaymentFinalRateDiffThreshold|Der berechnete Tilgungsplan weicht von der vorgegebenen Schlussrate ab, liegt aber noch innerhalb der Toleranz.||@Krone
FinancingRepaymentHeader|Tilgungplankopf||@Krone
FinancingRepaymentLines|Tilgungplanpositionen||@Krone
FinancingRepaymentLineTable|Tilgungspositionentabelle||@Krone
FinancingRepaymentLineTableStaging|Tilgungspositionen-Stagingtabelle||@Krone
FinancingRepaymentTable|Tilgungsplantabelle||@Krone
FinancingRepaymentTableCalcBatchCaption|Tilgungspläne berechnen||@Krone
FinancingRepaymentTableCalcTmp|Tilgungsplan-Berechnungstabelle||@Krone
FinancingRepaymentTablePostBatchCaption|Tilgungspläne buchen||@Krone
FinancingRepaymentTablePostTmp|Tilgungsplan-Buchungstabelle||@Krone
FinancingRepaymentTablePostTmpNotExist|Vertrag %1 in Stagingtabelle nicht gefunden||@Krone
FinancingRepaymentTableStaging|Tilgungsplan-Stagingtabelle||@Krone
FinancingRequest|Finanzierungsanfrage||@Krone
FinancingRequestApproval|Finanzierungsvertragsgenehmigung||@Krone
FinancingRequested|Finanzierungsanfrage gestellt||@Krone
FinancingRequestGrant|Finanzierungsanfrage genehmigen||@Krone
FinancingRequestJournal|Finanzierungsanfrageerfassung||@Krone
FinancingRequestJournalStaging|Finanzierungsanfrageerfassung Staging||@Krone
FinancingRequestPost|Finanzierungsanfrage buchen||@Krone
FinancingRequestTrans|Finanzierungsanfrageposition||@Krone
Financings|Finanzierungen||@Krone
FinancingStartDate|Finanzierungsstartdatum||@Krone
FinancingTransDiffTable|Finanzierungsdifferenztabelle||@Krone
FinancingType|Finanzierungstyp||@Krone
FinancingTypeChangeError|Es kann nur auf einen Finanzierungstyp gewechselt werden, der ebenfalls debitorisch bzw. kreditorisch ist.||@Krone
Finished|Abgeschlossen||@Krone
FirstOfMonth|Erster des Monats||@Krone
FirstReg|Erstzulassung||@Krone
FixedAssets|Anlagevermögen||@Krone
FixFactor|Faktor Fix||@Krone
ForeginVisit|Fremdbesuch||@Krone
ForeginVisitHelp|Aktivitäten in Verbindung mit einem Mietgerät, welches durch Dritte serviciert wird.||@Krone
FormatRegistrationNumber|Registriernummer-Format||@Krone
FreeInterestPeriod|Zinsfreie Periode||@Krone
FreeRepaymentPeriod|Tilgungsfreie Periode||@Krone
FreeRepaymentPeriods|Tilgungsfreie Perioden||@Krone
FreeRepaymentPeriodsStaging|Tilgungsfreie Perioden Stagingtabelle||@Krone
FromLegacySystem|Aus Altsystem||@Krone
General|Allgemeines||@Krone
GeneralAttachments|DocuRef Anhänge (URL / Notizen)||@Krone
GeneralAttachmentsUI|Importierte URL Anhänge||@Krone
GeneralLedgerAccounts|Sachkonten||@Krone
Generate|Generieren||@Krone
GenNxtNumSeq|Nächsten Nummernkreis generieren||@Krone
GenNxtNumSeqMaintain|Nächsten Nummernkreis generieren verwalten||@Krone
GenNxtNumSeqView|Nächsten Nummernkreis generieren ansehen||@Krone
GlobalKroneParameterMaintain|Krone globale Parameter verwalten||@Krone
GlobalRegistrationNumberCountryFormatsInquire|Land-Formate der Registrierungsnummer anzeigen||@Krone
GlobalRegistrationNumberCountryFormatsMaintain|Land-Formate der Registrierungsnummer verwalten||@Krone
GlobalRegistrationNumbers|Globale Registrierungsnummern||@Krone
GlobalRegistrationNumbersInquire|Globale Registriernummern anzeigen||@Krone
GlobalRegistrationNumbersMaintain|Globale Registriernummern verwalten||@Krone
GoodGuy|Good Guy||@Krone
Grant|Genehmigen||@Krone
GuaranteeAmount|Garantiebetrag||@Krone
GuaranteeBank|Garantiegeber||@Krone
GuaranteeID|Garantie ID||@Krone
GuaranteeLine|Garantiepositionen||@Krone
GuaranteeLineMaintain|Garantiepositionen verwalten||@Krone
GuaranteeLineView|Garantiepositionen ansehen||@Krone
GuaranteeNum|Garantienummer||@Krone
GuaranteeService|Sicherheitsleistung||@Krone
GuaranteeUnitConvert|Konvertierungseinheit||@Krone
HandOverLog|Übergabeprotokoll||@Krone
HandOverLogMenuItem|Lieferprotokolle||@Krone
Hop|Hop||@Krone
Identifier|Kennung||@Krone
InCheck|In Prüfung||@Krone
InitSAPData|SAP Merkmale initialisieren||@Krone
InRepair|In Reparatur||@Krone
Inspection|Inspektion||@Krone
Interest|Zinsen||@Krone
InterestAccount|Konto Zinsen||@Krone
InterestDate|Zinsdatum||@Krone
InterestInvoiceExpectationAccount|Konto Rechnungserwartung Zinsen||@Krone
InterestOffsetAccount|Gegenkonto Zinsen||@Krone
InterestPostingAt|Zinsbuchung am||@Krone
InterestSchedule|Zinsplan||@Krone
InterestStartDate|Zinsstartdatum||@Krone
InterfaceLog|Schnittstellen Log||@Krone
InterfaceLogView|Schnittstellen Log sehen||@Krone
Interfaces|Schnittstellen||@Krone
InvalidDocumentType|Ungültiger Dokumententyp||@Krone
InventModuleSettings|Artikeleinheiten Einstellungen||@Krone
InventModuleSettingsMaintain|Artikeleinheiten Einstellungen verwalten||@Krone
InventModuleSettingsView|Artikeleinheiten Einstellungen ansehen||@Krone
InvoiceExpectation|Rechnungserwartung||@Krone
InvoiceJournalReady|Die Kreditorenrechnungserfassung '%1' wurde im Unternehmen '%2' erstellt und ist buchungsbereit.||@Krone
IsAutomaticPrinted|Automatisch Gedruckt||@Krone
isReclassifiedTo|Anlage %1 - %2 wird neuklassifiziert zu %3 - %4.||@Krone
ItemMappingTable|Externe Artikelnummern||@Krone
ItemRepair|Reparatur Artikel||@Krone
ItemRepairHelp|Artikelnummer für Reparatur Paket zur Schadensbehebung||@Krone
Journal4FinProviderInvoices|Journal für Finanzierungsgeberrechnungen||@Krone
JournalForSystemRemoval|Journal für Anlagenablösungen||@Krone
Journals|Journale||@Krone
Krone|Krone Fleet||@Krone
KroneFleetGrp|Krone Fleet Referenzen||@Krone
KroneParameter|Krone Parameter||@Krone
KroneParameterDuty|Krone Parameter||@Krone
KroneParameterMaintain|Krone Parameter verwalten||@Krone
KroneParametersGlobal|Krone Parameter (global)||@Krone
KroneParametersGlobalDeveloperDocumentation|Die Tabelle RD_ParametersGlobal enthält alle mandantenübergreifenden Parameter der Krone Fleet Anpassungen||@Krone
LastCheckAdmissionCountryChange|Letzte Änderung des Zulassungslandes prüfen||@Krone
LastCheckAdmissionCountryChangeBatch|Letzte Änderung des Zulassungslandes prüfen Batch||@Krone
LastCheckAdmissionCountryChangeBatchMaintain|Letzte Änderung des Zulassungslandes prüfen Batch verwalten||@Krone
LastCheckAdmissionCountryChangeHelp|Datum gibt an, wann der Master das letzte Mal auf einen Wechsel des Zulassungslandes geprüft wurde.||@Krone
LastOfMonth|Letzter des Monats||@Krone
LedgerJournal|Sachkontenjournal||@Krone
LeftInner|Links innen||@Krone
LeftOuter|Links außen||@Krone
Lines|Positionen||@Krone
Login|Login||@Krone
LongTerm|Langzeit||@Krone
MaintenanceDate|Servicetermin||@Krone
MaintenanceDateDescription|Datum an dem der Service ausgeführt werden soll. Sagt nichts über der Dauer des Services aus.||@Krone
MaintenanceType|Wartungstyp||@Krone
MaintenanceTypeDescription|Kurzbeschreibung der Servicetypen aus Fremdsystem||@Krone
MasterContractLineDelHelpText|Entfernt den Vertrag aus dem Rahmenvertrag. Der Vertrag selbst wird nicht gelöscht.||@Krone
MasterRepaymentPlan|Tilgungsrahmenplan||@Krone
MasterRepaymentStatus|Status Tilgungsrahmenplan||@Krone
MasterRepaymentTable|Tilgungsrahmentabelle||@Krone
MasterRepaymentTableStaging|Tilgungsrahmen-Stagingtabelle||@Krone
MaterialCalc|Material kalkuliert||@Krone
MaterialCharge|Material Weiterbelastung||@Krone
MatType|Materialkosten||@Krone
MaxState|Max. Status||@Krone
MinState|Min. Status||@Krone
Modified|Angepasst||@Krone
NeedsNewCalculation|Benötigt Neuberechnung||@Krone
NetAmount|Nettobetrag||@Krone
NetAmountCalc|Nettobetrag kalkuliert||@Krone
NetAmountCharge|Nettobetrag Weiterbelastung||@Krone
NewerApprovalAlreadyGranted|Eine neuere Genehmigung wurde bereits erteilt||@Krone
NewLabel0|Label files created on 01/18/2022 08:09:54 for label file Id KroneD365 and language de||@Krone
NewLabel1|Kurzbeschreibung des Servicetyps aus Fremdsystem||@Krone
NewLabel2|Zeile %1: %2||@Krone
NewLabel3|Es wurden %1 Artikel importiert||@Krone
NewLabel4|New Text||@Krone
NewLabel5|New Text||@Krone
NoAnnuityAmount|Annuitätsbetrag muss angegeben werden||@Krone
NoBankDocumentType|Kein Bankdokumenttyp||@Krone
NoBankDocumentTypeSelectedContinueAnyway|Es wurde kein Bankdokumenttyp ausgewählt. Möchten Sie trotzdem fortfahren?||@Krone
NoCancellation|Stornierung nicht möglich||@Krone
NoFinancingAmount|Der Finanzierungsbetrag muss angegeben werden||@Krone
NoFinancingAssetGroupFound|Keine passende Anlagengruppe in Finanzierungstypen für Vertragsposition %1 (%2) gefunden||@Krone
NoGuarantee|Keine Bankgarantie||@Krone
NoGuaranteeSelectedContinueAnyway|Es wurde keine Bankgarantie ausgewählt. Möchten Sie trotzdem fortfahren?||@Krone
NoInspectionFound|Keine Inspektion gefunden||@Krone
NoInterestPosting|Keine Zinsbuchung||@Krone
NoInterestStartDate|Es muss ein Zinsstartdatum angegeben werden||@Krone
NominalInterestRate|Nominalzinssatz||@Krone
None|Kein||@Krone
NoNominalInterestRate|Der Nominalzinssatz muss angegeben werden||@Krone
NoPeriod|Die Vertragslaufzeit muss angegeben werden||@Krone
NoRecordForSearchTerm|Kein Datensatz für Suchbegriff "%1" gefunden||@Krone
NoRemovalRequest|Für die Vertragsposition '%1' muss erst eine Ablöseanfrage gestellt werden||@Krone
NoRepaymentStartDate|Es muss ein Tilgungsstartdatum angegeben werden||@Krone
NoRepaymentTableStartDate|Es muss ein Tilgungsplanstartdatum angegeben werden||@Krone
NoReverseTransferOfSystemGroups|Umbuchungen von Anlagengruppen können nicht storniert werden!||@Krone
NoStartDate|Es muss ein Startdatum angegeben werden||@Krone
NumberSequenceMustBeManual|Nummernkreis %1 muss auf "Manuell" stehen||@Krone
OffsetAccount|Gegenkonto||@Krone
OnlySelectPositionsWithItemIds|Nur Posten mit Artikelnummer berücksichtigen||@Krone
OnSiteVisit|Vor Ort Besuch||@Krone
OnSiteVisitHelp|Aktivitäten in Verbindung mit einem Mietgerät, welches vor Ort durch Servicetechniker serviciert wird.||@Krone
OrderNumbExt|Externe Auftragsnummer||@Krone
OrderNumbExtHelp|Auftragsnummer aus dem Ordersystem||@Krone
OrderStatusWorkshop|Auftragsstatus Werkstatt||@Krone
OrderSubtypeIsRental|Mietrechnung||@Krone
OrderSupTypeWorkshop|Werkstatt||@Krone
OriginalAssetId|Ursprüngliche Anlagennnumer||@Krone
OriginAssetId|Ursprungsanlagennummer||@Krone
OSCalcMask|OS Kalkulationsmaske||@Krone
OSCalcMaskMaintain|OS Kalkulationsmaske verwalten||@Krone
OtherCostCalc|Sonstige Kosten kalkuliert||@Krone
OtherCostCharge|Sonstige Kosten Weiterbelastung||@Krone
OtherRates|Weitere Tarife||@Krone
OtherType|Sonstige Kosten||@Krone
Overview|Übersicht||@Krone
PainterCalc|Lackierer kalkuliert||@Krone
PainterCharge|Lackierer Weiterbelastung||@Krone
PainterDuration|Lackierer Dauer||@Krone
PainterType|Lackierer||@Krone
ParamValue|Parameter Werte||@Krone
ParamValueMaintain|Parameter Werte verwalten||@Krone
ParamValueView|Parameter Werte ansehen||@Krone
Pass|Durchlauf %1||@Krone
Password|Kennwort||@Krone
PasswordConfirm|Kennwort wiederholen||@Krone
PasswordLock|Passwortsperre||@Krone
PasswordReset|Passwort wurde zurückgesetzt||@Krone
PasswordSetNew|Neues Kennwort setzen||@Krone
PasswordsNoMatch|Kennwörter stimmen nicht überein||@Krone
PasswordUnlock|Kennwort zum Entsperren||@Krone
PaymentInArrear|nachschüssige Zahlung||@Krone
Period|Laufzeit||@Krone
PosFactor|Positionenfaktor||@Krone
Position|Position||@Krone
PositionView|Positionsdarstellung||@Krone
PositionViewHelptext|Der Name dieses Produkts wird verwendet, wenn die Mietgerätpositionen gruppiert angedruckt werden||@Krone
Posted|Posted||@Krone
Posting|Buchung||@Krone
PostingDate|Gebucht am||@Krone
PriceCalc|Preiskalkulation||@Krone
PriceCalcFactor|Preis-Faktor||@Krone
PricesCanBeCombinedOnlyIfTheUnitsAreTheSame|Preise können nur zusammengefasst werden, wenn die Einheiten gleich sind||@Krone
PrintAarticlePrintPriceMayOnlyBeChangedForPeriodicUnits|Artikel drucken, Preis drucken darf nur bei Periodischen Einheiten geändert werden.||@Krone
PrintArticlePrintPriceMayBeChangedOnlyIfAllUnitsAreIdentical|Artikel drucken, Preis drucken darf nur geändert werden, wenn alle Einheiten identisch sind.||@Krone
PrintDate|Druckdatum||@Krone
PrintItem|Artikel drucken||@Krone
PrintPrice|Preis drucken||@Krone
ProcessState|Prozess Status||@Krone
ProductName|Produktname||@Krone
ProfileDepth|Profiltiefe||@Krone
ProtocolType|Protokoll-Typ||@Krone
PurchaseOrder|Bestellung||@Krone
PurchStatusWorkshop|Bestellstatus Werkstatt||@Krone
PurchTaxGrpParam|Einkauf Steuergruppe||@Krone
Rate|Rate||@Krone
RD|Rödl Dynamics GmbH||@Krone
RDA347|%1 darf nicht gefüllt werden, wenn %2 nicht %3 entspricht||@Krone
RDA348|%1 muss gefüllt werden, wenn %2 %3 entspricht||@Krone
RDA349|Versuch eine zirkuläre Beziehung zu erstellen festgestellt||@Krone
RDA350|Keine Debitoren innerhalb der Struktur vorhanden||@Krone
RDA351|Die Kundenstruktur ist gültig||@Krone
RDA352|Pfad beginnend bei Debitor %1 (%2) endet nicht im %3||@Krone
RDA353|%1 muss mit Header identisch sein||@Krone
RDA354|Ein %1 darf nicht in einer untergeordneten Ebene sein||@Krone
RDA355|Verweis der übergeordneten Ebene ist bereits in %2 "%1" enthalten||@Krone
RDA356|Verweis der untergeordneten Ebene ist bereits in %2 "%1" enthalten||@Krone
RD_ExternalType_ECR|ECR||@Krone
RD_ExternalType_Help|Externe Typ||@Krone
RD_ExternalType_Label|Typ||@Krone
RD_ExternalType_None| ||@Krone
RD_ExtInventTable_Display_Help|Artikel externe Nummer||@Krone
RD_ExtInventTable_Display_Label|Externe Artikelnummer||@Krone
RD_ExtInventTable_Table_GrpOverview|Übersicht||@Krone
RD_ExtInventTable_Table_Label|Externe Artikelnummer||@Krone
RD_ExtItemId_Help|Artikel externe Nummer||@Krone
RD_ExtItemId_Label|Externe Nummer||@Krone
RD_Miscellaneous|Sonstige Mietbedingungen||@Krone
RD_ProductSpecifics|Produktspezifika||@Krone
ReadyForInv|Bereit zum fakturieren||@Krone
ReceiptPostings|Belegbuchungen||@Krone
Reclassification|Neuklassifizierung||@Krone
ReclassificationError|Neuklassifizierung abgebrochen||@Krone
ReclassificationFromFinancing|Neuklassifizierung Vertragsposition %1 (%2)||@Krone
ReclassificationJournal|Journal für Neuklassifizierung||@Krone
Reclassified|Neuklassifiziert||@Krone
ReclassifyAssetGroups|Umbuchung Anlagengruppen||@Krone
RegistrationNumberCountryFormats|Land-Formate der Registrierungsnummer||@Krone
RegistrationNumbersList|Registriernummernliste||@Krone
RemainderDebt|Restschuld||@Krone
RemainderDebtCorporate|Restschuld in Konzernwährung||@Krone
RemainderDebtMST|Restschuld in Unternehmenswährung||@Krone
Removal|Ablösung||@Krone
RemovalAccount|Konto Ablösung||@Krone
RemovalInvoiceExpectationAccount|Konto Rechnungserwartung Ablösung||@Krone
RemovalJournalPost|Ablösung des Finanzierungsvertrag '%1', Periode '%2'||@Krone
RemovalNotPossible|Die letzte Rate wurde bereits verbucht. Eine Ablösung ist somit nicht mehr zulässig. Bitte stornieren Sie zunächst die letzte Rate oder ändern Sie die Vertragskonditionen.||@Krone
RemovalOffsetAccount|Gegenkonto Ablösung||@Krone
RemovalPost|Ablösen||@Krone
RemovalRequest|Ablösung anfragen||@Krone
RemovalRequestCancel|Ablösungsanfrage verwerfen||@Krone
RemovalRequestDiscard|Ablöseanfrage verwerfen||@Krone
RemovalRequested|Ablösung angefragt||@Krone
Removed|Abgelöst||@Krone
Rent|Vermietung||@Krone
Rentable|Vermietbar||@Krone
RentalAccount|Referenz Kunde||@Krone
RentalDevices|Mietgeräte||@Krone
RentalPackage|Rental Package||@Krone
RentalPackageCompact|Rental package Kompakt||@Krone
RentalPackageDetail|Rental package Detail||@Krone
RentalTransaction|Miet-Transaktionstatus||@Krone
RentalTransactionHelp|Externe Transaktionstatus||@Krone
RentDeviceLines|Mietgerätpositionen||@Krone
RentItemOtherRates|Mietitem - andere Raten||@Krone
RentOrder|Mietauftrag||@Krone
RentParam|Mietparameter||@Krone
RentParamMaintain|Mietparameter verwalten||@Krone
RentParamView|Mietparameter ansehen||@Krone
RentTableCreate|Mietauftrag erstellen||@Krone
RentTableCreated|Mietauftrag %1 wurde erstellt.||@Krone
RentTableCreateMaintain|Mietauftrag erstellen verwalten||@Krone
RentWorkshopProcess|Vermietung-/Werkstattprozess||@Krone
RentWorkshopProcessHelp|Übergeordneter Prozess in der Zusammenarbeit zwischen Vermietung und Werkstatt.||@Krone
Repair|Reparatur||@Krone
Repaired|Repariert||@Krone
Repayment|Tilgung||@Krone
RepaymentAccount|Konto Tilgung||@Krone
RepaymentAlreadyInvoiced|Der Tilungsplan wurde bereits abgerechnet||@Krone
RepaymentDate|Tilgungsdatum||@Krone
RepaymentInvoiceExpectationAccount|Konto Rechnungserwartung Tilgung||@Krone
RepaymentJournalNameId|Journal für Tilgungsplanbuchungen||@Krone
RepaymentJournalPost|Tilgungsplanbuchungen zum Finanzierungsvertrag '%1', Periode '%2', Typ '%3'||@Krone
RepaymentLeasing|Tilgung / Leasing||@Krone
RepaymentLineAdjustmentAtWrongPeriod|Manuelle Korrekturen können nur in ungebuchte Perioden oder die letzte gebuchte Periode angewendet werden.||@Krone
RepaymentLineCancel|Tilgungsplanzeile stornieren||@Krone
RepaymentLineCancelImpossible|Der Storno der importierten Tilgungsplanpositionen (Periode %1) ist nicht möglich, bitte nutzen Sie hierzu eine manuelle Korrektur||@Krone
RepaymentLineCancelNextFirst|Die nachfolgende Position des Tilgungsplans (Position %1) muss vor dieser Tilgungsplanposition storniert werden.||@Krone
RepaymentLineGapToPrevious|Zwischen den Tilgungsplanzeilen Periode '%1' und Periode '%2' darf es keine Lücken geben.||@Krone
RepaymentLineNoPrevious|Zu Tilgungsplanzeile Periode '%1' wurde keine Vorgängerzeile gefunden.||@Krone
RepaymentLinePost|Tilgungsplanzeile buchen||@Krone
RepaymentLinePreviousNotBooked|Die vorherige Position des Tilgungsplans (Position %1) muss vor dieser Tilgungsplanposition gebucht werden.||@Krone
RepaymentOffsetAccount|Gegenkonto Tilgung||@Krone
RepaymentPeriodAlreadyCancelled|Periode '%1' des Tilgungsplans wurde bereits storniert||@Krone
RepaymentPeriodAlreadyPosted|Periode '%1' des Tilgungsplans wurde bereits gebucht||@Krone
RepaymentPlan|Tilgungsplan||@Krone
RepaymentPlanCalculate|Tilgungsplan berechnen||@Krone
RepaymentPlanCreate|Tilgungsplan erstellen||@Krone
RepaymentPlanMustBeCalculated|Der Tilgungsplan muss berechnet werden||@Krone
RepaymentPlanPost|Tilgungspläne buchen||@Krone
RepaymentPlanSubledger|Ausgleich (Tilgungsplan / Nebenbuch)||@Krone
RepaymentPostingAt|Tilgungsbuchung am||@Krone
RepaymentStartDate|Tilgungsstartdatum||@Krone
RepaymentStatus|Status Tilgungsplan||@Krone
RepaymentTableNoPostings|Der Tilgungsplan wurde noch nicht gebucht||@Krone
RepaymentTableStartDate|Tilgungsplanstartdatum||@Krone
RepaymentType|Tilgungstyp||@Krone
RepaymentTypes|Tilgungstypen||@Krone
RequestAmount|Anfragebetrag||@Krone
Requests|Anfragen||@Krone
Reserve|Reserve||@Krone
ResidualDebt|Restschuld||@Krone
RestartRepayment|Wiederanlauf Tilgung||@Krone
ReturnDelivery|Rücklieferung||@Krone
ReturnDlv|Rücklieferung||@Krone
ReturnDlvHelp|Aktivitäten in Verbindung mit der Rücklieferung eines Mietgeräts vom Kunden.||@Krone
ReturnDlvTerm|Rücklieferungsbedingung||@Krone
RightInner|Rechts innen||@Krone
RightOuter|Rechts außen||@Krone
RoundingDiff|Rundingsdifferenz||@Krone
RoundingDiffGeneralLedger|Rundungsdifferenzen Hauptbuch||@Krone
RoundingDiffType|Rundingsdifferenztyp||@Krone
RuntimeExtension|Laufzeitverlängerung||@Krone
SalaryCalc|Lohn kalkuliert||@Krone
SalaryCharge|Lohn Weiterbelastung||@Krone
SalaryDuration|Lohn Dauer||@Krone
SalaryType|Arbeitslohn||@Krone
SalesMonths|Umsatz Anzahl Monate||@Krone
SalesTaxGrpParam|Verkauf Steuergruppe||@Krone
SAPDataInco|SAP Daten eingearbeitet||@Krone
SAPDataIncoHelp|Wenn die Daten aus SAP via Batchjob in D365 SCM übernommen worden sind, wird der Check auf Ja gesetzt.||@Krone
SAPInitDone|SAP-Reifen Initialisierung wurde durchgeführt||@Krone
SAPInitDoneDate|SAP-Reifen Initialisierungsdatum||@Krone
SAPOrderNum|SAP Auftragsnummer||@Krone
SAPPropertyId|SAP Merkmal-ID||@Krone
SAPPurchLineUpdate|SAP Bestellupdate||@Krone
SAPPurchLineUpdateBatch|SAP Bestellupdate Batch||@Krone
SAPPurchLineUpdateBatchMaintain|SAP Bestellupdate Batch verwalten||@Krone
SAPPurchLineUpdateEntityMaintain|SAP Bestellupdate Entität verwalten||@Krone
SAPPurchLineUpdateEntityView|SAP Bestellupdate Entität einsehen||@Krone
SAPPurchLineUpdateMaintain|SAP Bestellupdate verwalten||@Krone
SAPPurchLineUpdateView|SAP Bestellupdate einsehen||@Krone
ScheduledMaintenanceDates|Geplanter Servicetermine||@Krone
ScheduledMaintenanceTableUpdate|Geplante Servicetermine aktualisieren||@Krone
ScheduledMaintenanceTableView|Geplante Servicetermine einsehen||@Krone
ScrapValueInPercent|Schrottwert in Prozent||@Krone
SeconConfigitReference|Secon/Configit Referenz||@Krone
Sent|Gesendet||@Krone
SerialNum|Seriennummer||@Krone
SerialNumHelp|Die Seriennummer des aktuell montierten Reifens||@Krone
ServiceTypeClass|Servicetypen||@Krone
ServiceTypeClassEntityMaintain|Servicetypen Entität verwalten||@Krone
ServiceTypeClassEntityView|Servicetypen Entität einsehen||@Krone
ServiceTypeClassHelp|Servicetypen pro Markennummer (Gerätemarke), Klassenummer (Geräteklasse) und Land (Zulassungsstelle)||@Krone
ServiceTypeClassMaintain|Servicetypen verwalten||@Krone
ServiceTypeClassView|Servicetypen einsehen||@Krone
ServiceTypeDescription|Servicetyp Beschreibung||@Krone
SetupAccountingRules|Buchhaltungsvorschriften einrichten||@Krone
SetupAssets|Einstellungen für Anlagen einrichten||@Krone
SetupFinancingInformation|Standardwerte für Verträge und Rahmenverträge einrichten||@Krone
ShortTerm|Kurzzeit||@Krone
SourceSystemType_Datineo|Datineo||@Krone
SourceSystemType_Ordersystem|ECR Ordersystem||@Krone
SourceSystemType_SAP|SAP||@Krone
SpecialPayment|Sonderzahlung||@Krone
SpecialPaymentAccount|Konto Sonderzahlung||@Krone
SpecialPaymentOffsetAccount|Gegenkonto Sonderzahlung||@Krone
SpecialPaymentVendAccount|Konto Rechnungserwartung Sonderzahlung||@Krone
Standard|Standard||@Krone
StatusChargingOnOrder|Status Weiterbelastungsauftrag||@Krone
StatusReport|Zustandsbericht||@Krone
SubmenuFleet|Krone Fleet||@Krone
SubordinateLevel|Untergeordnete Ebene||@Krone
SumsDoNotMatch|Summen der Genehmigungspositionen und Vertragspositionen stimmen nicht überein||@Krone
SuperordinateLevel|Übergeordnete Ebene||@Krone
TableIdMappingTable|CDS Tabellen Mapping||@Krone
TabSelect| ||@Krone
TGPrice|HV Preis||@Krone
Threshold|Schwellenwert||@Krone
TimeExtensionOnlyWithType|Die Laufzeitverlängerung kann nur bei der Art %1 aktiviert werden.||@Krone
TimeInterval|Zeitraum||@Krone
TimeOfProtocolCreation|Zeitpunkt der Protokollerstellung||@Krone
TimeOfProtocolCreationHelp|Datum und Uhrzeit wann der Protokoll im Fremdsystem erstellt wurde.||@Krone
TireData|Reifendaten||@Krone
TireDataEntityMaintain|Reifendaten Entität verwalten||@Krone
TireDataEntityView|Reifendaten Entität einsehen||@Krone
TireDataMaintain|Reifendaten verwalten||@Krone
TireDataView|Reifendaten einsehen||@Krone
TireInUse|Reifen in Gebrauch||@Krone
TireMountedDate|Aufgezogen am||@Krone
TireMountedDateHelp|An dieses Datum wurde der Reifen aufzogen. Feld-Wert wird gesetzt bei neuer Seriennummer.||@Krone
TireNum|Reifennummer||@Krone
TireNumHelp|Die Reifennummer wird auch Seriennummer benannt. Ergibt zusammen mit dem EAN Code eine eindeutige ID.||@Krone
TirePattern|Profiltyp||@Krone
TirePosition|Seite||@Krone
TirePositionHelp|Die Seite definiert zusammen mit der Achse der Position am Gerät, wo der Reifen montiert ist.||@Krone
TiresInUse|Reifen in Einsatz||@Krone
TireSize|Reifengröße||@Krone
TireSizeHelp|Die Reifengröße ist zusammengesetzt aus der Reifenbreite, Reifenquerschnittverhältnis und Felgendurchmesser.||@Krone
Transactions|Transaktionen||@Krone
Transfer|Übertragen||@Krone
Undefined|Undefiniert||@Krone
UpdateCanceled|Aktualisierung wurde abgebrochen||@Krone
UsageUnit|Neue Zählereinheit||@Krone
UsedSince|In Verwendung seit||@Krone
ValidateCustStruct|Kundenstruktur überprüfen||@Krone
Valuta|Vortrag||@Krone
ValutaAccount|Konto Vortrag||@Krone
ValutaOffsetAccount|Gegenkonto Vortrag||@Krone
ValutaVendAccount|Konto Rechnungserwartung Vortrag||@Krone
VarInterest|Zinssatz variabel||@Krone
VehicleRegistrationDocument|Fahrzeugbrief||@Krone
VendInvAcc|Kreditoren Rechnungskonto||@Krone
VendInvAccMaintain|Kreditoren Rechnungskonto verwalten||@Krone
VendInvAccView|Kreditoren Rechnungskonto ansehen||@Krone
VendMapping|Kreditorenmapping||@Krone
View|Ansehen||@Krone
WarrantyDebitor|Garantie Debitor||@Krone
WheelRim|Felge||@Krone
WhereaboutsVehicleRegistrationDocument|Verbleib Fahrzeugbrief||@Krone
WorkshopCatId|Werkstatt Kategorie Id||@Krone
WorkshopCats|Werkstatt Kategorien||@Krone
WorkshopCatsEntityMaintain|Werkstatt Kategorien Entität verwalten||@Krone
WorkshopCatsEntityView|Werkstatt Kategorien Entität ansehen||@Krone
WorkshopCatsMaintain|Werkstatt Kategorien verwalten||@Krone
WorkshopCatType|Werkstatt Kategorie Typ||@Krone
WorkshopVisit|Werkstatt Besuch||@Krone
WorkshopVisitHelp|Aktivitäten in Verbindung mit einem Mietgerät, welches sich in der Werkstatt befindet.||@Krone
